0 0 0 0 0 8 8 8 8 8 8 8 8 8 8 8 8 8 8 8 8 0 0 0 0 0
0 0 0 0 8 8 8 8 8 0 0 0 0 0 0 0 0 8 8 8 8 0 0 0 0 0
0 0 0 0 0 8 8 8 8 0 0 0 0 0 0 0 0 0 8 8 8 8 0 0 0 0
0 0 0 0 8 8 8 8 8 0 0 0 0 0 0 3 0 8 8 8 8 0 0 0 0 0
0 0 0 0 0 8 8 8 8 0 0 0 0 0 0 0 3 3 8 8 8 8 0 0 0 0
0 0 0 0 8 8 8 8 0 0 0 0 0 0 0 0 3 0 8 8 8 0 0 0 0 0
0 0 0 0 0 8 8 8 8 0 0 0 0 0 0 0 3 0 8 8 8 0 0 0 0 0
0 0 0 0 8 8 8 8 8 0 0 0 0 0 0 0 3 0 8 8 8 0 0 0 0 0
0 0 0 0 0 8 8 8 8 0 0 0 0 0 0 0 0 0 8 8 8 8 0 0 0 0
0 0 0 0 8 8 8 8 0 0 0 0 0 0 0 0 0 0 8 8 8 0 0 0 0 0
0 0 0 0 0 8 8 8 8 0 0 0 0 0 0 0 0 0 8 8 8 8 0 0 0 0
0 0 0 0 8 8 8 8 0 0 0 0 0 0 0 0 0 0 8 8 8 0 0 0 0 0
0 0 0 0 0 8 8 8 0 0 0 0 0 0 0 0 0 0 8 8 8 0 0 0 0 0
0 0 0 0 0 8 8 8 0 0 0 0 0 0 0 0 0 0 8 8 8 0 0 0 0 0
0 0 0 0 0 8 8 8 0 0 0 0 0 0 0 0 0 0 8 8 8 0 0 0 0 0
0 0 0 0 0 8 8 8 0 0 0 0 1 0 0 0 0 0 8 8 8 0 0 0 0 0
0 0 0 0 0 8 8 8 0 0 0 0 1 0 0 0 0 0 8 8 8 0 0 0 0 0
0 0 0 0 0 8 8 8 0 0 0 0 0 0 0 0 0 0 8 8 8 0 0 0 0 0
0 0 0 0 0 8 8 8 0 0 0 1 1 0 0 0 0 0 8 8 8 0 0 0 0 0
0 0 0 0 0 8 8 8 0 0 1 1 0 0 0 0 0 0 8 8 8 0 0 0 0 0
0 0 0 0 0 8 8 8 8 0 0 1 0 0 0 0 0 0 8 8 8 8 0 0 0 0
0 0 0 0 0 8 8 8 8 0 1 0 0 0 0 0 0 0 8 8 8 0 0 0 0 0
0 0 0 0 0 8 8 8 8 0 1 0 0 0 0 0 0 0 8 8 8 0 0 0 0 0
0 0 0 0 0 8 8 8 8 8 1 0 0 0 0 0 0 0 8 8 8 0 0 0 0 0
0 0 0 0 0 0 8 8 8 8 8 8 0 0 0 0 8 8 8 8 8 8 0 0 0 0
0 0 0 0 0 8 8 8 8 8 8 8 8 8 8 8 8 8 8 8 8 0 0 0 0 0
