8 8 8 8 8 8 8 8 8 8 8 8 0 0 0 8 8 8 8 8 8 8 8 8 8 8
8 8 8 8 8 8 8 8 8 8 8 8 0 0 0 8 8 8 8 8 8 8 8 8 8 8
8 8 8 8 8 8 8 8 8 8 8 8 0 0 0 8 8 8 8 8 8 8 8 8 8 8
8 8 8 8 8 8 8 8 8 8 8 8 0 0 0 8 8 8 8 8 8 8 8 8 8 8
8 8 8 8 8 8 8 8 8 8 8 8 0 0 0 8 8 8 8 8 8 8 8 8 8 8
8 8 8 8 8 8 8 8 8 8 8 8 0 0 0 0 100 8 8 8 8 8 8 8 8 8
8 8 8 8 8 8 8 8 8 8 8 8 0 0 8 8 8 8 8 8 8 8 8 8 8 8
8 8 8 8 8 8 8 8 8 0 0 0 0 0 0 0 0 0 0 8 8 8 8 8 8 8
8 8 8 8 8 3 3 0 0 0 0 0 0 0 0 0 0 0 0 8 0 8 8 8 8 8
8 8 8 8 8 3 3 0 0 0 0 0 0 0 0 0 0 0 0 0 0 0 0 8 8 8
8 8 8 8 3 3 0 0 0 0 0 0 0 0 0 0 0 0 0 0 0 0 0 8 8 8
8 8 8 8 3 0 0 0 0 0 0 0 0 0 0 0 0 8 8 0 0 0 0 0 0 8
8 8 8 8 3 0 0 0 0 0 0 0 0 0 0 0 0 8 8 0 0 0 0 0 8 8
8 8 8 8 3 0 0 0 0 0 0 0 0 0 0 0 0 8 8 8 0 0 0 0 0 0
8 8 8 8 3 0 0 0 0 0 0 0 0 0 0 8 8 8 8 0 0 0 0 0 0 0
8 8 8 8 3 0 0 0 0 0 0 0 0 0 0 0 0 8 0 0 0 0 0 0 0 2
8 8 0 0 0 0 0 0 0 0 0 0 0 0 0 0 0 8 0 0 0 0 0 0 0 0
8 8 8 8 8 8 8 8 8 8 8 0 0 0 0 0 0 8 0 9 0 8 0 0 0 0
8 8 8 8 8 8 8 8 8 8 8 8 0 0 0 0 0 8 0 0 0 8 0 0 0 0
8 8 8 8 0 8 8 8 8 8 8 8 8 0 0 0 0 8 0 0 0 8 0 0 0 0
8 8 8 8 0 8 8 8 8 8 8 8 8 8 0 0 0 8 0 0 0 0 0 0 0 0
8 8 8 8 8 8 8 8 8 8 8 8 8 8 8 8 8 8 0 0 0 0 0 0 8 8
8 8 8 8 8 8 8 8 8 8 8 8 8 8 8 8 8 0 0 0 0 0 8 8 8 8
8 8 8 8 8 8 8 8 8 8 8 8 8 8 8 8 8 8 8 8 8 8 8 8 8 8
8 8 8 8 8 8 8 8 8 8 8 8 8 8 8 8 8 8 8 8 8 8 8 8 8 8
